#############################################################
+   #   # #     #     #           # # #   # #   # #         #
# # # # # ##### # ####### # ### ### # # ### ### # # # # ### #
# #   # #     #         # #   #       # #   # #     # #   # #
##### # # ##### # # ### # ### # ####### ### # ### ###########
#     # # #   # # #   # # # # # #     # #     # #     # #   #
####### # # ### ####### ### ### # ##### # ### # ### ### # ###
#     #         #     #           #   #     # #             #
### ########### # # ### # # ### ### ### # ### # ### # # ### #
# # # # # #   #   # # # # # #           #   # #   # # #   # #
# # # # # # ####### # # # # ### # # ######### ##### ### ### #
# #   # # # #   #   # # # # #   # #   #     #         #   # #
# # # # # # # ##### # ####### ##### # # ##### # ### ##### ###
#   # #   #       #   #         # # # #   #   # #     # #   #
# ##### ### ### # # ### ##### # # ####### ##### ##### # #####
#     #     # # # # #     # # # #   # #   # # # #   #   #   #
# ####### # # ######### # # # # # # # # ### # # ### # ### # #
#       # #       #   # # #   # # #   #   #   # # # #     # #
# ### ### # ### # # # ### # # # ### ##### # ##### # # # #####
# #       #   # #   # #   # # # #                     # #   #
### ### ### ####### ##### ########### ### ####### # # ### ###
#   #     #     #     # # #   #   # # # #       # # #   # # #
# ####### ##### ### ### # # ### ### ### # ######### ##### # #
#   #       # # # # #     # #     #     # # # #     # #     #
# ### ### ### ### ##### # # # ### ##### # # # ##### # # #####
#   #   #       #       #   #   #   # #   #   #     #     # #
# # # # ### # ##### # ##### ### ##### # ##### ### ### ### # #
# # # # #   # #     # #   # #     #         # # # # #   #   #
### # ##### # ### ####### # ##### # ######### # ### # ### ###
#   # #     #     # # #     # # #         # #   # #   #     #
##### ##### ##### # # # ### # # # # # # ### ### # # ### # # #
# # # #     #   #     #   # #     # # #   # #   #   # # # # #
# # # # ### # ##### # ##### # ##### ### # # # ### # # # ### #
# #   # #   #   # # # #     #   #   # # #       # # #   #   #
# # ##### ### ### ######### ######### # ### ### # ###########
#   # #   #   # # # #   #     #       # # # # #   #   #     #
# ### ##### ### # # # ##### # ### # # ### # # # ##### # #####
# #     #         # #       #     # #   # #   # #     #     #
# # ### ### # ### # ### # # ##### ### ### # ### # # # # # # #
#     #     #   #   #   # #     # #   #     #     # #   # # -
#############################################################
